########################################
#......................................#
#......................................#
#..........F...........................#
#..........................*...........#
#..........................*...........#
#..........................*...........#
#..........................*...........#
#......................................#
#..........S...............*...........#
#..........................*...........#
#..........................*...........#
#..........................*...........#
#..........................*...........#
#..........................*...........#
#......................................#
#............#.........................#
#......................................#
#......................................#
########################################