########################################
#..........#...........................#
#..........#...........................#
#..........#...........S...............#
#..........#...........................#
#..........#...........................#
###...######...........................#
#......................................#
#......................................#
###***#########........................#
#.............#........................#
#.............#########......###########
#.............#........................#
#.............#........................#
#.............#........................#
#.............######...................#
#..................#...................#
#..................*........F..........#
#..................#...................#
########################################