########################################
#............................*.........#
#..S.........................*.........#
############.................*.........#
#..........#................############
#..........#######.....................#
#...########...........................#
#.......#..............................#
#.......#..............................#
#......................................#
##########**.....#######################
#.........#*...........................#
#....F....#*...........................#
#.........#*...........................#
#.....#####*...........................#
#.....******...........................#
#......................................#
#......................................#
#......................................#
########################################