########################################
#..............#*......................#
#..............#*......................#
#..............#*......................#
#...............*......................#
#..............#*......................#
#..............#*......................#
################*......................#
#......................................#
#..........S...........................#
#......................................#
#################......................#
#...............#......................#
#...............#......................#
#***#***#***#***#***#***#***#***#***#**#
#......................................#
#............F.........................#
#......................................#
#......................................#
########################################