####################
#............F.....#
#....F.............#
#..................#
#....S.............#
####################
