####################
#..................#
#..S...............#
#..........F.......#
#..................#
####################