########################################
#.............#........................#
#.............#........................#
#.............#........................#
#.............#........................#
#.............#...............S........#
#.............#####....................#
#.................#....................#
#.................#....................#
#.................#....................#
#..............******....******........#
#......................................#
#......................................#
#..............**********..............#
#......................................#
#..................F...................#
#......................................#
#......................................#
#......................................#
########################################